0 0 0 5 5 5 5 5 5 5 5 5 5 5 5 5 0 0 0 0 
0 0 0 5 2 22 0 0 0 0 0 0 0 0 18 5 0 0 0 0 
0 0 0 5 0 0 0 0 2 0 0 0 2 0 0 5 0 0 0 0 
0 0 0 5 0 1 1 1 1 1 0 1 1 1 1 5 0 0 0 0 
0 0 0 5 0 1 1 0 1 1 0 1 1 0 1 5 0 0 0 0 
0 0 0 5 0 1 0 1 0 1 0 1 0 1 1 5 0 0 0 0 
0 0 0 5 0 1 1 1 1 1 0 1 1 0 1 5 0 0 0 0 
0 0 0 5 0 0 0 0 0 0 0 1 1 1 1 5 0 0 0 0 
0 0 0 5 0 0 0 0 0 0 0 0 0 0 0 5 0 0 0 0 
0 0 0 5 3 3 3 3 3 3 3 3 3 0 3 5 0 0 0 0 
0 0 0 5 3 3 3 3 3 3 3 3 3 0 3 5 0 0 0 0 
0 0 0 5 0 15 0 0 0 0 0 0 0 0 0 5 0 0 0 0 
0 0 0 5 0 17 0 2 2 2 0 2 2 2 0 5 0 0 0 0 
0 0 0 5 0 15 0 0 0 0 0 0 0 0 0 5 0 0 0 0 
0 0 0 5 5 5 5 5 5 5 5 5 5 5 5 5 0 0 0 0 
