0 0 5 5 5 5 5 5 5 5 5 5 5 5 5 5 5 0 0 0 
0 0 5 0 0 0 0 1 5 18 5 1 0 0 0 0 5 0 0 0 
0 0 5 0 0 0 0 1 16 0 16 1 0 0 0 0 5 0 0 0 
0 0 5 0 0 22 0 1 16 0 16 1 0 0 0 0 5 0 0 0 
0 0 5 0 0 0 0 1 1 1 1 1 0 0 0 0 5 0 0 0 
0 0 5 0 0 0 0 0 0 0 0 0 0 0 0 0 5 0 0 0 
0 0 5 0 0 0 0 0 0 0 0 0 0 0 0 0 5 0 0 0 
0 0 5 0 0 5 0 5 3 3 3 0 0 0 0 0 5 0 0 0 
0 0 5 5 5 5 0 5 3 0 3 5 5 5 5 0 5 0 0 0 
0 0 5 0 0 5 0 5 3 3 3 0 0 0 0 0 5 0 0 0 
0 0 5 0 0 0 0 0 0 0 0 0 0 0 0 0 5 0 0 0 
0 0 5 0 0 0 0 0 0 0 0 0 0 0 0 0 5 0 0 0 
0 0 5 0 0 0 0 0 15 17 15 0 0 0 0 0 5 0 0 0 
0 0 5 0 0 0 0 0 15 0 15 0 0 0 0 0 5 0 0 0 
0 0 5 5 5 5 5 5 5 5 5 5 5 5 5 5 5 0 0 0 
