0 0 0 0 0 0 0 0 0 0 0 0 2 0 0 0 0 0 0 0 
0 0 0 0 0 0 0 2 0 0 2 0 2 0 0 0 0 0 0 0 
0 0 0 0 0 0 0 0 0 0 0 0 2 0 15 0 0 0 0 0 
2 2 2 2 2 2 0 0 0 0 0 0 2 0 0 15 0 0 0 0 
0 0 0 0 0 2 0 2 0 0 2 0 2 0 17 0 15 0 0 0 
0 2 0 2 0 2 0 0 0 0 0 0 0 0 0 0 0 0 0 0 
0 0 0 0 0 2 0 0 2 2 2 2 0 0 2 2 2 2 2 2 
0 2 0 2 0 2 0 0 0 0 0 0 2 0 0 0 0 0 0 0 
0 0 0 0 0 2 0 0 0 0 0 0 2 0 0 3 3 3 3 0 
0 2 0 2 0 2 0 0 0 18 0 0 2 0 0 3 0 0 3 0 
0 0 0 0 0 2 0 0 0 0 0 0 2 0 3 3 0 0 3 0 
0 2 0 2 0 2 2 2 0 0 0 0 2 0 3 0 0 3 3 0 
0 0 0 0 0 0 0 0 0 0 0 0 2 0 3 0 0 3 0 0 
0 2 0 2 0 2 0 2 0 22 0 2 2 0 3 3 3 3 0 0 
0 0 0 0 0 0 0 0 0 0 0 0 0 0 0 0 0 0 0 0 
