7 7 7 7 7 7 0 0 0 16 0 16 0 0 0 7 7 7 7 7 
7 7 7 7 7 7 0 0 2 2 18 2 2 0 0 7 7 7 7 7 
7 7 7 7 7 7 0 7 7 2 0 2 7 7 0 7 7 7 7 7 
7 7 7 7 7 7 0 7 7 2 0 2 7 7 0 7 7 7 7 7 
7 7 7 7 7 7 0 7 7 0 0 0 7 7 0 7 7 7 7 7 
7 7 7 7 7 7 0 7 7 7 7 7 7 7 0 7 7 7 7 7 
7 7 7 7 7 7 0 2 7 7 7 7 7 7 0 7 7 7 7 7 
7 7 7 7 7 7 0 0 7 7 0 7 7 2 0 7 7 7 7 7 
7 7 7 7 7 7 0 0 7 7 22 7 7 0 0 7 7 7 7 7 
7 7 7 7 7 7 0 2 7 7 0 7 7 0 0 7 7 7 7 7 
7 7 7 7 7 7 0 7 7 7 7 7 7 2 0 7 7 7 7 7 
7 7 7 7 7 7 0 7 7 7 7 7 7 7 0 7 7 7 7 7 
7 7 7 7 7 7 0 7 7 0 7 0 7 7 0 7 7 7 7 7 
7 7 7 7 7 7 0 0 0 0 15 0 0 0 0 7 7 7 7 7 
7 7 7 7 7 7 2 0 15 0 17 0 15 0 2 7 7 7 7 7 
