4 3 3 3 3 3 3 3 3 3 3 3 5 5 5 5 5 5 5 5 
4 3 0 0 0 0 0 0 0 0 0 3 4 4 4 4 4 4 4 4 
4 3 0 0 0 5 0 5 0 0 0 3 5 5 5 5 5 5 5 5 
4 3 0 0 16 3 0 3 16 0 0 3 4 4 4 4 4 4 4 4 
4 3 0 0 3 4 0 4 3 0 0 3 4 4 4 4 4 4 4 4 
4 3 0 3 4 4 0 4 4 3 3 3 4 4 4 4 4 4 4 4 
4 3 0 3 4 4 18 4 4 3 0 3 4 4 4 4 4 4 4 4 
4 3 0 0 3 4 4 4 3 0 0 3 4 4 4 4 4 4 4 4 
4 3 0 0 16 3 4 3 16 0 0 3 3 3 3 3 3 3 3 3 
4 3 0 0 0 0 22 0 0 0 0 0 0 0 0 0 0 0 0 3 
4 3 0 0 3 3 3 3 3 3 3 0 0 0 0 15 0 15 0 3 
4 3 0 0 0 0 0 0 0 0 0 0 0 0 0 0 15 0 0 3 
4 3 0 0 0 0 0 0 0 0 0 0 0 0 0 15 0 15 0 3 
4 3 3 3 3 3 3 3 3 3 3 3 3 3 3 0 0 0 17 3 
4 3 3 3 3 3 3 3 3 3 3 3 3 3 3 3 3 3 3 3 
