8 8 8 8 8 8 8 8 8 8 8 8 8 8 8 8 8 8 8 8 
8 8 5 5 5 5 5 5 5 5 5 5 5 5 5 5 5 5 5 8 
8 8 5 8 8 8 8 8 16 16 18 16 16 8 8 8 8 8 5 8 
8 8 5 8 8 8 0 0 8 0 5 0 8 0 0 8 8 8 5 8 
8 8 5 8 8 0 8 8 8 0 8 0 8 8 8 0 8 8 5 8 
8 8 5 8 0 8 8 8 8 8 8 8 8 8 8 8 0 8 5 8 
8 8 5 8 0 8 8 8 8 5 8 5 8 8 8 0 0 0 5 8 
8 8 5 22 0 8 5 8 5 0 0 0 5 8 5 0 8 0 5 8 
8 8 5 8 0 8 8 8 8 5 8 5 8 8 8 0 0 0 5 8 
8 8 5 8 0 8 8 8 8 5 8 5 8 8 8 8 0 8 5 8 
8 8 5 8 8 0 8 8 0 8 0 8 0 8 8 0 8 8 5 8 
8 8 5 8 8 0 0 0 0 5 5 5 0 0 0 0 8 8 5 8 
8 8 5 8 8 8 8 8 15 15 17 15 15 8 8 8 8 8 5 8 
8 8 5 5 5 5 5 5 5 5 5 5 5 5 5 5 5 5 5 8 
8 8 8 8 8 8 8 8 8 8 8 8 8 8 8 8 8 8 8 8 
