0 0 0 0 0 0 5 0 0 17 0 0 5 0 0 0 0 0 0 0 
5 5 5 5 0 0 5 0 15 0 15 0 5 0 0 5 5 5 5 5 
0 0 0 5 0 0 5 0 15 0 15 0 5 0 0 5 0 0 0 0 
5 5 0 5 0 0 5 0 5 0 5 0 5 0 0 5 0 5 5 0 
0 0 0 5 0 0 5 0 0 0 0 0 5 0 0 5 0 0 0 0 
0 0 0 5 5 5 5 0 0 0 0 0 5 5 5 5 0 0 0 0 
0 0 0 0 0 0 0 0 5 0 5 0 0 0 0 0 0 0 0 0 
0 0 0 0 0 0 0 0 0 0 0 0 0 0 0 0 0 0 0 0 
5 5 0 5 5 5 5 5 0 0 0 5 5 5 5 5 0 5 5 0 
0 0 0 0 0 0 25 5 5 25 5 5 25 0 0 5 0 0 0 0 
5 5 5 5 0 5 5 5 0 0 0 5 5 5 0 5 5 5 5 5 
0 0 0 5 0 5 0 0 0 1 0 0 0 5 0 0 0 5 0 5 
0 5 0 0 0 5 16 5 0 0 0 5 16 5 0 5 0 5 0 22 
0 0 5 5 5 5 5 0 16 0 16 0 5 5 0 5 0 0 0 5 
22 0 0 0 0 0 0 0 0 18 0 0 0 0 0 5 5 5 5 5 
