4 4 4 4 3 3 3 3 3 3 3 3 3 3 3 3 3 4 4 4 
4 0 0 18 3 3 3 3 3 3 3 3 3 3 3 3 3 3 4 4 
4 0 3 3 3 2 2 2 2 2 2 3 3 3 3 3 3 3 3 4 
4 0 0 0 3 0 0 0 0 0 2 2 4 4 4 4 4 3 3 3 
3 0 2 0 0 0 0 3 0 0 0 0 4 0 0 0 4 2 0 2 
3 0 2 0 0 3 0 3 0 3 0 0 0 0 3 0 4 0 15 17 
3 0 2 0 3 3 3 3 3 3 3 0 0 0 3 0 0 15 15 15 
0 0 2 0 0 3 0 3 0 3 0 0 4 0 0 0 4 0 15 0 
3 0 2 2 0 0 0 3 0 0 0 0 4 0 0 0 4 2 0 2 
3 0 22 2 0 0 0 0 0 2 2 2 4 4 4 4 4 0 0 3 
3 2 0 2 2 2 2 0 0 2 0 0 0 3 0 3 0 0 0 3 
3 3 3 3 0 0 0 0 2 2 0 0 0 0 0 0 0 0 3 3 
4 3 3 3 3 0 0 0 0 0 0 3 0 3 0 3 0 3 3 4 
4 4 3 3 3 3 3 3 3 0 3 3 0 3 3 3 0 3 4 4 
4 4 4 4 3 3 3 3 3 3 3 3 3 3 3 3 4 4 4 4 
