10 10 10 10 10 10 10 10 10 10 10 10 10 10 10 10 10 10 10 10 
10 10 10 10 10 10 10 10 10 10 10 10 10 10 0 0 0 0 10 10 
10 10 10 10 10 10 10 10 10 10 10 10 10 0 2 0 0 2 0 10 
10 10 0 0 0 0 10 10 10 10 10 10 0 0 0 15 15 0 0 0 
10 10 0 2 2 0 10 10 10 10 10 10 10 0 2 0 0 2 0 10 
10 0 0 15 15 0 0 10 10 10 10 10 10 10 0 0 0 0 10 10 
10 0 2 17 15 2 0 10 10 10 0 10 10 10 10 0 0 10 10 10 
10 0 0 0 0 0 0 10 10 10 10 10 10 10 10 0 0 10 10 10 
10 10 0 2 2 0 10 10 10 10 10 10 10 0 0 0 10 10 10 10 
10 10 0 0 0 0 10 10 10 10 10 10 0 0 0 0 10 10 22 10 
10 10 10 0 0 10 10 10 10 10 10 0 0 0 0 10 10 10 10 10 
10 0 0 0 0 0 0 10 0 0 0 0 0 2 0 0 0 18 10 10 
10 22 0 0 0 0 0 0 0 0 0 0 0 2 0 10 10 10 10 10 
10 10 0 0 0 0 0 10 10 10 0 0 0 0 0 0 0 0 10 10 
10 10 10 10 10 10 10 10 10 10 10 10 10 10 10 10 10 10 10 10 
